133
12
1000000000000000000000000000000000000000000000000000000000000000000000000000000000000000000000000000000000000000000000000000000000001
1000000000000000000000000000000000000000000000000000000000000000000000000000000000000000000000000000000000000000000000000000000000001
1000000000000000000000000000000000000000000000000000000000000000000000000000000000000000000000000000000000000000000000000000000000001
1000000000000000000000000000000000000000000000000000000000000000000000000000000000000000000000000000000000000000000000000000000000001
1000000000000000000000000000000000000000000000000000000000000000000000000000000000000000000000005500550000000000000000000000000000001
1000000000000000000000000000000000000000000000000000000000000000000000000000000000000000000000050055005000000000000000000000000000001
1000000000000000000000055555000000000000000000000000000000000000000000000000000000000000000000005000050000000000000000000000000000001
1000000000006660000000022222000000006666660000000000000000000000000000000002626262000000000000000522500000000000000000000000000000001
1000000000000000000000000000000000000000000000000000000000000000000000000000000000000000000000000055000000000000000000000000000000001
1000000000000000000000000000000000000000000000000000000055555500000000000000000000000000000000000000000000000000000000000000000000001
1000000000000000003000000000000400000000000000030004000000000000000004030000000000000000040000000000000000000000400000000000800000001
1111111111111111111111111111111111111111111111111111111111111111111111111111111111111111111111111111111111111111111111111111111111111
